22 22 22 22 22 22 22 22 22 22 22 22 22 22 22 22 22 22 23 55 32 32 55 21 22 22 22 22 22 22
22 22 22 22 22 22 22 22 22 22 22 22 22 22 22 22 22 22 23 55 32 32 55 21 22 22 22 22 22 22
22 22 22 22 53 38 38 38 38 38 38 38 38 38 38 38 38 38 39 55 32 32 55 37 38 38 54 22 22 22
22 22 22 22 23 1 2 2 2 3 2 2 2 2 2 2 2 2 4 55 32 32 55 1 2 2 21 22 22 22
22 22 22 22 23 1 2 2 2 3 2 2 2 2 2 2 2 2 4 55 32 32 55 1 2 2 21 22 22 22
22 22 22 22 23 1 2 2 2 3 2 2 2 2 2 2 2 2 4 55 32 32 55 1 2 2 21 22 22 22
22 22 22 22 23 17 19 18 18 18 18 18 18 18 18 18 18 18 20 55 32 32 55 17 18 18 21 22 22 22
22 22 22 22 23 50 32 32 32 32 32 32 32 32 32 32 32 32 32 32 32 32 55 55 55 55 21 22 22 22
22 22 22 22 23 66 32 32 32 32 32 32 32 32 32 32 32 32 32 32 32 97 55 55 55 55 21 22 22 22
22 22 22 22 69 6 6 6 6 6 6 6 6 6 6 6 6 6 6 6 6 6 6 6 6 6 70 22 22 22
22 22 22 22 22 22 22 22 22 22 22 22 22 22 22 22 22 22 22 22 22 22 22 22 22 22 22 22 22 22
22 22 22 22 22 22 22 22 22 22 22 22 22 22 22 22 22 22 22 22 22 22 22 22 22 22 22 22 22 22
22 22 22 22 22 22 22 22 22 22 22 22 22 22 22 22 22 22 22 22 22 22 22 22 22 22 22 22 22 22
22 22 22 22 22 22 22 22 22 22 22 22 22 22 22 22 22 22 22 22 22 22 22 22 22 22 22 22 22 22
